11111111111
1C0C0P00EC1
1C0C11C0001
1C0C1000001
1C001000C01
1C001100C01
1C000000C01
11111111111
