1111111111111111111111
1001C0C0000000P1000E01
1001C0C100000010000001
1001C0C100000000000001
1000C0C100000000000001
1111111111111111111111