1111111111111111111111
1000C0C0000000P0000E01
1000C0C000000000000001
1000C0C000000000000001
1000C0C000000000000001
1111111111111111111111