11111111111
1C0C0P00EC1
1C0C11C0001
1C0C1000001
11111111111
